10
+-+-+-+-+-+-+-+-+-+-+
|                   |
+ +-+-+-+-+-+-+-+-+ +
| |A         V    | |
+ +               + +
| |      V        | |
+ +   +-+-+-+-+-+-+ +
| |               | |
+ + +-+-+-+-+-+-+-+ +
|                   |
+                   +
|          P        |
+                   +
|                   |
+                   +
|                   |
+                   +
|                   |
+ +-+-+         +-+ +
|    V|         |T  |
+-+-+-+-+-+-+-+-+-+-+
