10
+-+-+-+-+-+-+-+-+-+-+
|         |         |
+ + +     +     +   +
| | |           |   |
+ +-+-+     + +-+   +
|           |H      |
+   +   +-+ + +-+-+ +
|   |               |
+-+ +     +-+-+-+ + +
|   |       |T|   | |
+-+ + +     + +-+ + +
|     |  A V  |     |
+ +   +     +-+ +-+ +
| |   |     | |     |
+ +   +     + +     +
|      P    |       |
+   +-+-+-+-+ + +   +
|         |   | |   |
+         +   + + +-+
|                   |
+-+-+-+-+-+-+-+-+-+-+
