10
+-+-+-+-+-+-+-+-+-+-+
|           |       |
+   + + +-+-+ +-+ + +
|   | |    T      | |
+   + +-+ +     + + +
|         |     | | |
+ +-+ + + +-+   + + +
|   | | |           |
+ + +-+ +   +-+   +-+
| |   |  V        |P|
+ +   + + +-+-+   + +
|       |H          |
+ +-+ + +-+-+     +-+
|     |    A      | |
+ +-+-+-+-+ +     + +
|   |       |       |
+   + +-+ +-+ +     +
|             |     |
+     +-+     + +-+ +
|                   |
+-+-+-+-+-+-+-+-+-+-+
