10
+-+-+-+-+-+-+-+-+-+-+
|     |           | |
+ +   +-+ +-+-+ + + +
| |             |   |
+ + + + +-+     +-+-+
| | | |      H  | | |
+ + +-+   +-+ + + + +
|     |       |     |
+     +-+   + +-+ + +
|     |     |     | |
+   + + +-+ + +   + +
|T  | |       |   | |
+ +-+ +-+     +-+ + +
|     |P       V  | |
+-+ +-+-+-+-+ +-+ +-+
|   |     |   |     |
+ +-+   + +   + +   +
|  A    | |     |   |
+-+     +-+   +-+ + +
| |     |       | | |
+-+-+-+-+-+-+-+-+-+-+
