10
+-+-+-+-+-+-+-+-+-+-+
|                   |
+-+-+-+-+-+   +-+   +
|T            |     |
+-+ + +   +-+ +     +
|   | |    A        |
+   + +       +-+ + +
|  V            | | |
+     +-+ +-+-+-+ +-+
|P H    | | | |     |
+   + +-+ + + + + +-+
|   | |     |   | | |
+-+ + + + + +   + + +
|     | | | |       |
+     +-+-+-+   +-+ +
|           |       |
+ +   +-+ +-+ +-+ +-+
| |             |   |
+ +           + +-+ +
| |           |     |
+-+-+-+-+-+-+-+-+-+-+
