10
+-+-+-+-+-+-+-+-+-+-+
|           |       |
+   +-+-+-+ + + +-+ +
|       | |   |     |
+ +     + + +-+     +
| |       |   |     |
+ + +     +   + + +-+
|   |     |P    |   |
+-+-+     +     +-+ +
|    A    |        V|
+-+-+ +-+ + +   +   +
|     | | | |   |  T|
+-+-+ + +-+-+ +-+ +-+
|             | | | |
+     +-+-+ + +-+ + +
|       |   |     | |
+       +-+ +-+ +-+ +
|    H    | |       |
+-+ +-+-+ + +       +
| | |               |
+-+-+-+-+-+-+-+-+-+-+
