10
+-+-+-+-+-+-+-+-+-+-+
| |   |            H|
+ +   +   + +-+ +   +
|     |   |     |   |
+-+ + +   + + +-+   +
|   |     | |    P  |
+   + +-+ +-+       +
|       |           |
+ +-+   +-+ +-+     +
|   |   | | |       |
+ + +-+ + + +       +
| |     |           |
+-+ +   +     +     +
|   |         |     |
+-+-+         + + +-+
|               | | |
+-+   +-+       + + +
|       |           |
+ + +-+ +-+-+   + +-+
|T|    V       A|   |
+-+-+-+-+-+-+-+-+-+-+
