10
+-+-+-+-+-+-+-+-+-+-+
|         |      T| |
+   + +-+ +       +-+
|   | |  H          |
+   +-+-+ +       +-+
|         |V        |
+   +-+   +-+ +-+-+-+
|                 | |
+-+ +-+-+-+ +     + +
| |   |     |       |
+ +   + +-+ +   +-+ +
|            A      |
+-+ +   +-+     +-+ +
| | |               |
+ + +     +-+-+     +
|   |     |   |P    |
+   + +   + + +   +-+
|     |     |       |
+-+ + +     + +-+ +-+
|   |               |
+-+-+-+-+-+-+-+-+-+-+
